25
25
#########################
#   #               #   #
# # # # # # # # # # # # #
#   #               #   #
# # # # # # # # # # # # #
#   #               #   #
# # # # # # # # # # # # #
# A #               # S #
# # # # # # # # # # # # #
#   #               #   #
# # # # # # # # # # # # #
#   #               #   #
# # # # # # # # # # # # #
#   #               #   #
# # # # # # # # # # # # #
#   #               #   #
# # # # # # # # # # # # #
#   #               #   #
# # # # # # # # # # # # #
#   #               #   #
# # # # # # # # # # # # #
#   #               #   #
# # # # # # # # # # # # #
#   #               #   #
# # # # # # # # # # # # #
#   #               #   #
#########################
