################################
#_____________________________#
#_____________________________#
#_____________________________#
#_____________________________#
#_____________________________#
#______##_____________________#
#_____####____________________#
#_____###_____________________#
#______##_____________________#
#_____________________________#
#_____________________________#
#_____________________________#
#_____________________________#
#_____________________________#
#_____________________________#
#_____________________________#
#_____________________________#
#_____________________________#
#_____________________________#
#_____________________________#
#_____________________________#
#_____________________________#
#_____________________________#
#_____________________________#
#_____________________________#
#_____________________________#
#_____________________________#
#_____________________________#
#_____________________________#
################################