30
20
############################################################
#__________________________________________________________#
#__________________________________________________________#
#__________________________________________________________#
#__________________________________________________________#
#__________________________________________________________#
#__________________________________________________________#
#__________________________________________________________#
#__________________________________________________________#
#_________________##_______________________________________#
#_________________##_______________________________________#
#_________________##_______________________________________#
#_________________##_______________________________________#
#_________________##_______________________________________#
#_________________####_____________________________________#
#_________________####_____________________________________#
#_________________##_______________________________________#
#_________________##_______________________________________#
#__________________________________________________________#
#__________________________________________________________#
############################################################